GGGSRRRR|RRRRSGG
GGSRRRR|RRRRSGGG
GGSRRR|RRRRRSGGG
GGSRRRR|RRRRSGGG
GGGSRRRR|RRRRSGG
GGGGSRRRR|RRRRSG
GGGGGSRRRR|RRRRS
GGGGGSRRRR|RRRRS
GGGGGSRRRR|RRRRS
GGGGSRRRR|RRRRSG
GGGSRRRR|RRRRSGG
GGGSRRR|RRRRRSGG
